%%%%%%%%%%
%G   P ..%
%%%%%%%%%%
